NO ./textures/wall.xpm
SO ./textures/wood.xpm
WE ./textures/blue.xpm
EA ./textures/bricks_yellow.xpm

F 220,100,0
C 225,30,0

        11111
 111    10E01
1101    10101
1001111110000111
1000000000000001
1111111111111111